....................
..AbAbAbA...AbAbAbA.
..BaBaBaB...BaBaBaB.
..AbAbAbA...AbAbAbA.
..BaBaBaB...BaBaBaB.
....................
....................
....................
....................
....................
....................
....................
....................
....................
....................